22231311213231332323311112132231113131233111212221112332112233231322111231113122
22221221213133211122211322111312231212222331233133332322312212221323231122222132
31123231131131233221313332322131323231123313122331222113313231233131231332231112
12331231321333121131213231332213311211323321312131231333313331111313332312231132
11213132231222312233113321131322222221312321222111231132212112211123112211222312
23213323223332321113233131311112313312331222212332111322322123311121131111213232
13212123113111312333332321112321113121223313131221123113312133311131321311112212
23113323122213332213132323331211211232111121322132121313121233333322311322321322
21311213222133123121323121311221222111213213123233211133232212323131133131113312
23323131333312121232231122332133231111331231211231111313123111121211333211233112
11132212322221223321223111113223111333213231223223122231221232113131213313121122
31311113132111233222331232132222213312233211221223313212132121112311311331321112
32112132112221131221111331131211322132113132131211122221222222311233133333212222
22321212111212112121323323212331222331111213321122321313222123311112133111213112
21222333331123111213232121132311132122232132331221312322233212131113221212323212
12111233212131322212121323312212211231121221112223233211233331112313221112332212
13133122232321213312333211121312133333231311333322231112312313122133311133331312
23122331332132213311122122331132211121112212322111323132323321322113231212232112
33221131223133321121222322133221331223233113312331111211312332233112212312111322
21132233122211222123113133132132222122123313221222323131223131131231122332313322
33131211323333323321322221321211221322132132121123211231123221211311222322323322
31313111133321321231221233311231333321213113213131113331223121223212222112322132
12231121331132221212213331232132211333322122221331111323331212231332313232212112
31332332121112211113113222333223132113123133331323111322231232323132333321331132
13231333333321313323112111223132233233121212122212313132112231112321333113123122
23322233333312121312113111322233111221221223313121221333323231223133333331211332
12333133233223222323333111111122211312123132212333212321123323133331113331132212
22211133332221333321312113212331233231232332131232211121121323133313112332313212
21312221123133112133132111231123123111211213331321321112321313321222213322221132
32112122113333221321332132311322113123312211113331211223221312213322133333333122
11221312311322111123323221311131222323333332133322131313231313222131123131132222
11211313113211222312113323122313121222123132233211311122221333132231333332123232
13113122221113323223221212123212233313233231331121311221223312332322123223221222
22222131312321122323233211323132211321122233131133221233222132331112223322331312
32333213331311133223321331211222233232113212333312111213131113213321211321223132
33121231222133212321333123232232132221312212211333312132333313111131232222213312
11331213131113332113221211221333311333113331121212212213113221132332131222231232
31331132111123221323121122333212111321322321212122312122123222311332223133333322
33231311211112223221331132311122133211211221132133113123232113111321331133331112
31133312322212122123233112213331223112222211122213212333131333222223131332111222
21322122213211222131231223112222113323123333133321311313113221323132232212321122
22133113212222321233132213111132121221323133211313231112323231312133311223133212
21213131321333332122133213312321312233122333321333212112331323222323133112123212
21123221332113212221321311121111331322323321113232312131132232233223312311322332
21122311321313313332232213332113232133121111331132131312223113312332131323211232
11112131323323111332122233233232212113122122132132131212213222121321213311322112
32213132213313312211333122231331322233113213322211312113112113233321233313132332
11322233212232333113223232233111232233312321323123111233132112332312111333212132
32332112233311123333313221312212121222131212211113222311131212312331121132332212
22223231131331113122112131321111313322321222133132322213113312212331222221211132
12232321133221112232333121222211232222132231331212221122221122333233121112332322
21222132321332111333213321233331123233311311323311313123321113212131232311112312
22112233112132232133123312332233323311112112323211312312212112322333331231121232
12122322212123233132312123312223332223221111123122323132311313133322321313213122
11333132311223233121221323311332232133131132322132322111232311231131123113312112
23311132112213132323321131223312212121322131233213232332323322321222221121332332
33133211321223322211223312113313132132122231313112311313133311111112131313233312
32311321231133321321333233212223232323213312122132211121123112313232311232233312
12321123331231213313133312313322113122333312231222312321212213112322321212233122
11312213333323311123131112121313221211131121322332113131133312331222332232321322
21321233122112221222312313332211221122111311312323222223121332231231331232212122
33231122231323332232313332123123122233311112223131131333322121221331223313333212
21311111232121123332131211211211212332321312211331122233321222212221333112222112
32221111212333223323133223122123233212132111133123221332121131121332123231333112
13323113222322131122131322122223331123323221331133322113222311132323322332211132
13221121221313132111331121333311122333233131231232212121211331333131122233131332
11313331233132221222233122233312131212223333231333133112213232333322213311312332
33221131111131221313222232112313131111322332132333223313211232112332122121311332
31131221131312331312321121322211133223321321311321131322322133133322333221111322
22212111311121213333311111232223132212311313333223223321322232323123222133123212
11331123233211132231231321233232322113213131231332311323132221311232132322122332
33322113111133311222113233231311232121323332131321223111332212122233211211231312
32132223132312312233311221231232322113112331313233221312213221221333322132123122
31223212231211322332322312333312111133131112331323233231332132123111332331113212
22121232211231312111221111323313213331213111321121223132123211323133111311221122
11122333232223231213123113323323312221112333121311132112111332211233122221213222
11221232112212331311223211212312212122222232332213312331211321212312231213131332
33111313122121131322223333133322232223322331132232323121331323121311112213121312
13221132323131211313321131213332212111332112133322233112323133122212212322112312
11111111111111111111111111111111111111111111111111111111111111111111111111111110